+--+--+--+--+--+--+--+--+--+--+--+--+--+--+--+
|                                            |
+  +--+--+--+--+--+--+  +  +  +--+  +  +  +  +
|  |                    |     |  |           |
+  +  +--+  +  +--+--+  +  +  +--+  +  +  +  +
|  |  |  |           |  |                    |
+  +  +--+  +  +  +  +  +  +  +  +  +--+  +  +
|  |                 |  |           |  |     |
+  +  +  +  +  +--+  +  +  +  +  +  +--+  +  +
|  |           |  |  |  |                    |
+  +--+--+--+  +--+  +  +  +  +--+  +  +  +  +
|                    |  |     |  |           |
+  +--+--+--+--+--+--+  +  +  +--+  +  +  +  +
|                                            |
+--+--+--+--+--+--+--+--+--+--+--+--+--+--+--+
