+--+--+--+--+--+--+--+--+
|                       |
+  +  +  +  +  +  +  +  +
|                       |
+  +  +  +  +  +  +  +  +
|                       |
+  +  +  +  +  +  +  +  +
|                       |
+  +  +  +  +  +  +  +  +
|                       |
+  +  +  +  +  +  +  +  +
|                       |
+  +  +  +  +  +  +  +  +
|                       |
+--+--+--+--+--+--+--+--+
