+--+--+--+--+--+--+--+--+
|                       |
+  +--+--+--+--+--+--+  +
|  |                    |
+  +  +--+  +  +--+--+  +
|  |  |  |           |  |
+  +  +--+  +  +  +  +  +
|  |                 |  |
+  +  +  +  +  +--+  +  +
|  |           |  |  |  |
+  +--+--+--+  +--+  +  +
|                    |  |
+  +--+--+--+--+--+--+  +
|                       |
+--+--+--+--+--+--+--+--+
